nb rows=9
nb columns=9
entrance col=1
goal col=7
0 0 0 0 0 1 0
0 1 1 1 1 1 0
0 1 0 1 0 0 0
0 1 0 1 1 1 0
0 0 0 1 0 0 0
0 0 0 1 0 1 0
0 0 0 0 0 1 0